1111111111111
1011000000PC1
11C1011111001
101011E000001
1111111111111
