111111111111111111111111111111111
10000C001C00000111100C01000100001
10000000100000010000000100010C001
101011111000P11100111111000111001
111000000000000000000000000000001
1C1001111010000111000C00011111111
1000110000000000C1100000011111111
111001100000011100110110000C00001
11110111000100C111011011011111111
100001E11111000000001C001100000C1
1C000001000C000000000010000000001
111111111111111111111111111111111