1111111111111
1001000000PC1
10C0011111001
100P11E000001
1111111111111
